000000000000000000000000000000
00ABBBBC0000000000000000000000
00H1111D0000000000000000000000
00H1111D0000000000000000000000
00H1111D0000000000000000000000
00GFFFFE00000000fg000000000000
0000000000000000fg000000000000
00000000000fg00ehhd00000000000
0000000000ffgg0000000000000000
0000000000ehhd0000000000000000
000000fg0000000000000000000000
000000fg000000000000fg00000000
00000fiig00000000000fg00000000
00000ehhd0000000000ehhd0000000
000000000000000000000000000000
000000000000000000000000000000
000000000000000000000000000000
