mnnnnnnnnnnnnnnnnnnnnnnnnnnnnn
800000000000000000000000000000
7000000000000000NO000000000000
700000000000000IZaJ00000000000
70000000000NO00XZaY00000000000
7000000000IZaJ0XQPY00000000000
7880000000XZaY0R0kSl0000000000
799000NO00XQPY00j0000000000000
70000IZaJ0R00S000000NO00000000
70000XZaY000j000000IZaJ0000000
70000XQPY0000000000XZaY0000000
70000R00S0000000000XQPY0000000
7000l0k000000000000R00S0000000
7000000j0000000000000j00000000
700000000000000000000000000000
780000000000000000000000000000
990000000000000000000000000000
