------------------------------
0-----------------------------
------------------------------
------------------------------
------------------------------
------------------------------
------------------------------
333333333333333333333333333333
222222222222222222222222222222
ooooooooooooooooop22qooooooooo
00000000000000000r22s000000000
00000000000000000r22s000000000
00000000000000000r22s000000000
00000000000000000r22s000000000
00000000000000000r22s000000000
00000000000000000r22s000000000
00000000000000000r22s000000000
