111111111111111111111111111111
000000000000000000000000000000
000000000000000000000000110000
000001000001000000000000000000
000100000000000000000010000000
000000000000000000000000000000
000000000000000000000000000000
000000000000000000000000000000
000000000000000000000000000000
000000000100000000000000000000
000000000000000000000000001000
000000000000000000000000001000
000000010000000000000000000000
000000000000000000000000000000
000100000000000000001000000000
000000000000100000000000100000
000000000000000000000000000000
