111111111111111111111111111111
000000000000000000000000000000
000000000000000000000000000000
000000000000000000000000000000
000000000000000000000000000000
000000100000000000000001000000
000000000000000000000000000000
000000000000000000000000000000
000000000000000000000000000000
000000100000000000000001000000
000000000000000000000000000000
000000000000000000000000000000
000000000000000000000000000000
000000100000000000000001000000
000000000000000000000000000000
000000000000000000000000000000
000000000000000000000000000000
