------------------------------
bbbbbbbbbbbbbbBbbbbbbbbbbbbbbb
666666666666666666666666666666
666666666666666666666666666666
666666666666666666666666666666
666666666666666666666666666666
666666666666666666666666666666
666666666666666666666666666666
666666666666666666666666666666
666666666666666666666666666666
666666666666666666666666666666
666666666666666666666666666666
666666666666666666666666666666
666666666666666666666666666666
66666666666666j666666666666666
666666666666666666666666666666
666666666666666666666666666666

